Lab,none,1,0
IIIIIIIIIIIIIIIIIIIIIIIIII
IWWWWWWWWWWWWWWWWWWWWWWWWI
IWCCCCCCCCCCCCCCW2121212WI
IWCCCCCCCCCCCCCCW2121212WI
IWCCCCCCCCCCCCCCW2121212WI
IWCCCCCCCCCCCCCCW2121212WI
IWCCCCCCCCCCCCCCW2121212WI
IWCCCCCCCCCCCCCCW2121212WI
IWCCCCCCCCCCCCCCW2121212WI
IWCCCCCCCCCCCCCCW2121212WI
IWWWWWCCCWWWWWWWWWW***WWWI
I1111WRRRRRRRRRRRRRRRRRRWI
I1111WRRRRRRRRRRRRRRRRRRWI
I1111WRRRRRRRRRRRRRRRRRRWI
I1111WRRRRRRRRRRRRRRRRRRWI
I1111WRRRRRRRLLRRRRRRRRRWI
I1111WRRRRRRLLLLRRRRRRRRWI
I1111WRRRRRLL11LLRRRRRRRWI
IWWWWWRRRRRLL11LLRRRRRRRWI
IWRRR*RRRRRRLLLLRRRRRRRRWI
IWRRR*RRRRRRRLLRRRRRRRRRWI
IWRRR*RRRRRRRRRRRRRRRRRRWI
IWRRR*RRRRRRRRRRRRRRRRRRWI
IWWWWWWWWWWWWWWWWWWWWWWWWI
IIIIIIIIIIIIIIIIIIIIIIIIII