Grassy,none,1
IIIIIIIIIIIIIIIIIIIIII
I111WWWWWWW1RRRR11111I
I111WCCCCCW1RRRR11111I
I111WCCCCCC1RRRR11111I
I111WCCCCCC1RRRR11111I
I111WCCCCCW1RRRR11111I
I111WCCCCCW1RRRR1RRR1I
I111WCCCCCW1RRRR1RLR1I
I111WWWWWWW1RRRR1RRR1I
IRRRRRRRRRRRRRRRRRRRRI
IRRRRRRRRRRRRRRRRRRRRI
IRRRRRRRRRRRRRRRRRRRRI
IRRRRRRRRRRRRRRRRRRRRI
I11111RRRR111111RRR11I
I1WWWWCCCCW11111RRR11I
I1WCCCCCCCW111WWCCCWWI
I1WCCCCCCCW111WCCCCCWI
I1WCCCCCCCW111WCCCCCWI
I1WCCCCCCCW111WCCCCCWI
I1WCCCCCCCW111WCCCCCWI
I1WWWWWWWWW111WWWWWWWI
IIIIIIIIIIIIIIIIIIIIII
