Volcano,none,1,0
IIIIIIIIIIIIIIIIIIIIIIIIIIIIIIIIIIIIIIII
IWWWWWWWWWWWWWWWWWWWWWWWWWWWWWWWWWWPWWWI
IWRRRRRRRRRRPRRRRRRRRRRPRPRRRRRWRRRPRRWI
IWRRRRRRRRRRPRRRRRRRRRPPWRRRRRRWRRRRRRWI
IWWRRRRRRRRRWWRRRRRRRRPPRRRRRWRWRRRRRRWI
IWRRWRRRRRRRRWWRRRWRRRPPRRRRWWRWRRRRRRWI
IWRRWWWRRRRRRRWWWRWWRRPPPRRWWRRWRRRRRRWI
IWRRRRWRWRRRRRRRWRRWRRPPPRRWPRRWRRRRRRWI
IWRRRWWWRRPRRRRRWRRWRRPPRRRWRRRRRRRRRRWI
IWRRRPPRRRRWRRRRWRRWWRPPRRRWRRRRRRRRRRWI
IWRRRRPRRRRPRRRRWRRRWWPPRRWWRRWWRRRRRRWI
IWRPWWWWRRRWRRRRWWRRRWPPRRWRRWWRRRRRRRWI
IWPPRRRRRRRWWRRRRWWRRRPP1PWRRWRRRRRRRRWI
IWRRRRRRRRRRWRRRRRWWRRPPPPRRWWRRRRRRRRWI
IWRRRRRRRRRRWWRRRRWWRRRPRRRWWRRRRRRRRRWI
IWRRRRRRRRRRRWWRRRRWWRPPRRWWRRRRRRRRRWWI
IWRRRRRRRPRWRRWRRRRRWWPPRWWRRRRRRRWPPRWI
IWRRRRRRWRPWRPWRRRRRRWPPWWRRRRRRRPWPRWWI
IWRRRRRRRRRRWRWRRRRRRRPPRRRRRRRRWRRPPRWI
IWRRRRRRRRRRRRWRRRRRRRPPRRRRRRRWWRWRRWWI
IWRRRRRRRRRRRRWRRRRRRRPPRRRRRRPPRWRPWPWI
IWRRRRRRRRRRRRWRRRRRRRPPRRRRRWPRPPPRWPWI
IWRRRRRRRRRRRRWRRRRRRRPPRRRRPPPRWWRPRPWI
IWWWWWWWWWWWWWWWWWWWWWWWWWWWWWWWWWWWWWWI
IIIIIIIIIIIIIIIIIIIIIIIIIIIIIIIIIIIIIIII
