Grassy,none,1,0
IIIIIIIIIIIIIIIIIIIIIIIIIIIIIIIII
ILLLL111111111111111111111111111I
ILL11111111111111111111111111111I
IL111111111111111111111111111111I
I1111111111111111111111111111111I
I1111111111111111111111111111111I
I1111111111111111111111111111111I
I1111111111111111111111111111111I
I1111111111111111111111111111111I
I1111111111111111111111111111111I
I1111111111111111111111111111111I
I1111111111111111111111111111111I
I1111111111111111111111111111111I
I1111111111111111111111111111111I
I1111111111111112221111111111111I
I1111111111111122222111111111111I
I1111111111111222222111111111111I
I1111111111112222222111111111111I
I111111111111222222111111111111RI
I1111111111112222111111111111RRRI
I1111111111111111111111111RRRRRRI
I111111111111111111111RRRRRRRRRRI
I111111111111111111111RRRRRRRRRRI
I11111111111111111111RRRRRWWRRRRI
I11111111111111111111RRRRWWWRRRRI
I111LL11111111111111RRRRWWWRRRRRI
I11LLLL1111111111111RRRRWRRRRRRRI
I11LLLLL11111111111RRRRRRRRRRRRRI
I1LLLLLL11111111111RRRRRRRRRRRRRI
ILLLLLLL11111111111RRRRRRRRRRRRRI
ILLLLLL11111111111RRRRRRRRRRRRRRI
ILLL1111111111111RRRRRRRRRRRRRRRI
IIIIIIIIIIIIIIIIIIIIIIIIIIIIIIIII
