Grassy,none,1
IIIIIIIIIIIIII
I00WWWWWWWW00I
I0WWWWWWCCCW0I
IWWWWWWWCCCCWI
IWCCCCCCCCCCWI
IWCCCCCCCCCCWI
IWCCCCCCCCCCWI
IWCCCCCCCCCCWI
IWCCCCCCCCCCWI
IWCCCCCCCCCCWI
IWCCCCCCCCCCWI
I0WCCCCCCCCW0I
I00WWWWWWWW00I
IIIIIIIIIIIIII
