Grassy,none,1
IIIIIIIIIIIIIIIIIIIIIIIIIIIIIIIIIIIIIIIIIIIIIIIIIIIIIIIIIIIIIIIIIIIIIIIIIIIIIIIIIIIIIIIIIIIIIIIIIIIIIIIIIII
I111111111111111111111111111111111111111111111111111111111111111111111111111111111111111111111111111111111I
I111111111111111111111111111111111111111111111111111111111111111111111111111111111111111111111111111111111I
I111111111111111111111111111111111111111111111111111111111111111111111111111111111111111111111111111111111I
I111111111111111111111111111111111111111111111111111111111111111111111111111111111111111111111111111111111I
I111111111111111111111111111111111111111111111111111111111111111111111111111111111111111111111111111111111I
I111111111111111111111111111111111111111111111111111111111111111111111111111111111111111111111111111111111I
I111111111111111111111111111111111111111111111111111111111111111111111111111111111111111111111111111111111I
I111111111111111111111111111111111111111111111111111111111111111111111111111111111111111111111111111111111I
I111111111111111111111111111111111111111111111111111111111111111111111111111111111111111111111111111111111I
I111111111111111111111111111111111111111111111111111111111111111111111111111111111111111111111111111111111I
I111111111111111111111111111111111111111111111111111111111111111111111111111111111111111111111111111111111I
I111111111111111111111111111111111111111111111111111111111111111111111111111111111111111111111111111111111I
I111111111111111111111111111111111111111111111111111111111111111111111111111111111111111111111111111111111I
I111111111111111111111111111111111111111111111111111111111111111111111111111111111111111111111111111111111I
I111111111111111111111111111111111111111111111111111111111111111111111111111111111111111111111111111111111I
I111111111111111111111111111111111111111111111111111111111111111111111111111111111111111111111111111111111I
I111111111111111111111111111111111111111111111111111111111111111111111111111111111111111111111111111111111I
I111111111111111111111111111111111111111111111111111111111111111111111111111111111111111111111111111111111I
I111111111111111111111111111111111111111111111111111111111111111111111111111111111111111111111111111111111I
I111111111111111111111111111111111111111111111111111111111111111111111111111111111111111111111111111111111I
I111111111111111111111111111111111111111111111111111111111111111111111111111111111111111111111111111111111I
I111111111111111111111111111111111111111111111111111111111111111111111111111111111111111111111111111111111I
I111111111111111111111111111111111111111111111111111111111111111111111111111111111111111111111111111111111I
I111111111111111111111111111111111111111111111111111111111111111111111111111111111111111111111111111111111I
I111111111111111111111111111111111111111111111111111111111111111111111111111111111111111111111111111111111I
I111111111111111111111111111111111111111111111111111111111111111111111111111111111111111111111111111111111I
I111111111111111111111111111111111111111111111111111111111111111111111111111111111111111111111111111111111I
I111111111111111111111111111111111111111111111111111111111111111111111111111111111111111111111111111111111I
I111111111111111111111111111111111111111111111111111111111111111111111111111111111111111111111111111111111I
I111111111111111111111111111111111111111111111111111111111111111111111111111111111111111111111111111111111I
I111111111111111111111111111111111111111111111111111111111111111111111111111111111111111111111111111111111I
I111111111111111111111111111111111111111111111111111111111111111111111111111111111111111111111111111111111I
I111111111111111111111111111111111111111111111111111111111111111111111111111111111111111111111111111111111I
I111111111111111111111111111111111111111111111111111111111111111111111111111111111111111111111111111111111I
I111111111111111111111111111111111111111111111111111111111111111111111111111111111111111111111111111111111I
I111111111111111111111111111111111111111111111111111111111111111111111111111111111111111111111111111111111I
I111111111111111111111111111111111111111111111111111111111111111111111111111111111111111111111111111111111I
I111111111111111111111111111111111111111111111111111111111111111111111111111111111111111111111111111111111I
I111111111111111111111111111111111111111111111111WWWWWWWWWWWWWWWWWWWWCCWWWWWWCCWWWWWWWWWWWW111111111111111I
I111111111111111111111111111111111111111111111111WCCCCCCCWCCCCCCCCCCWCCCCCCCCCCWCCCCCCCCCCW111111111111111I
I111111111111111111111111111111111111111111111111WCCCCCCCWCCCCCCCCCCWCCCCCCCCCCWCCCCCCCCCCW111111111111111I
I111111111111111111111111111111111111111111111111WCCCCCCCWCCCCCCCCCCWCCCCCCCCCCWCCCCCCCCCCW111111111111111I
I111111111111111111111111111111111111111111111111WCCCCCCCWCCCCCCCCCCWCCWWCCWWCCWCCCCCCCCCCW111111111111111I
I111111111111111111111111111111111111111111111111WCCCCCCCWCCCCCCCCCCWCCWCCCCWCCWCCCCCCCCCCW111111111111111I
I111111111111111111111111111111111111111111111111WCCCCCCCWCCCCCCCCCCWCCWCCCCWCCWCCCCCCCCCCW111111111111111I
I111111111111111111111111111111111111111111111111WCCCCCCCWWWWWWWWWWCWCCCCWWWWCCWCWWWWWWWWWW111111111111111I
I111111111111111111111111111111111111111111111111WCCCCCCCCCCCCCCCCCCCCCWCWCCWCCCCCCCCCCCCCW111111111111111I
I111111111111111111111111111111111111111111111111WCCCCCCCCCCCCCCCCCCCCCWCCCCWCCCCCCCCCCCCCW111111111111111I
I111111111111111111111111111111111111111111111111WWWWWWWWWWWWCCCCCCCCCCWCCCCWCCCCCCCCCCCCCW111111111111111I
I111111111111111111111111111111111111111111111111WCCCCCCCCCCWCCCCCCCCCCWCCCCWCCCCCCCCCCCCCW111111111111111I
I111111111111111111111111111111111111111111111111WCCCCCCCCCCWCCWWWWWWWWWWWWWWCCWCWWWWWWWWWW111111111111111I
I111111111111111111111111111111111111111111111111WCCCCCCCCCCWCCCCCCCCCCCCCCCCCCWCCCCCCCCCCW111111111111111I
I111111111111111111111111111111111111111111111111WCCCCCCCCCCWCCCCCCCCCCCCCCCCCCWCCCCCCCCCCW111111111111111I
I111111111111111111111111111111111111111111111111WCCCCCCCCCCWCCWCCCCCCCCCCCCCCCWCCCCCCCCCCW111111111111111I
I111111111111111111111111111111111111111111111111WCCCCCCCCCCWCCWCCCCCCCCCCCCCCCWCCCCCCCCCCW111111111111111I
I111111111111111111111111111111111111111111111111WCCCCCCCCCCWCCWCCCCCCCCCCCCCCCWCCCCCCCCCCW111111111111111I
I111111111111111111111111111111111111111111111111WCCCCCCCCCCCCCWCCCCCCCCCCCCCCCWCCCCCCCCCCW111111111111111I
I111111111111111111111111111111111111111111111111WWWWWWWWWWWWWWWCCCCCCCCCCCCCCCWWWWWWWWWWWW111111111111111I
I11111111111111111111111111111111111111111111111111111111111111WCCCCCCCCCCCCCCCW11111111111111111111111111I
I11111111111111111111111111111111111111111111111111111111111111WCCCCCCCCCCCCCCCW11111111111111111111111111I
I11111111111111111111111111111111111111111111111111111111111111WCCCCCCCCCCCCCCCW11111111111111111111111111I
I11111111111111111111111111111111111111111111111111111111111111WWWWWWWWWWWWWWWWW11111111111111111111111111I
I111111111111111111111111111111111111111111111111111111111111111111111111111111111111111111111111111111111I
I111111111111111111111111111111111111111111111111111111111111111111111111111111111111111111111111111111111I
I111111111111111111111111111111111111111111111111111111111111111111111111111111111111111111111111111111111I
I111111111111111111111111111111111111111111111111111111111111111111111111111111111111111111111111111111111I
I111111111111111111111111111111111111111111111111111111111111111111111111111111111111111111111111111111111I
I111111111111111111111111111111111111111111111111111111111111111111111111111111111111111111111111111111111I
I111111111111111111111111111111111111111111111111111111111111111111111111111111111111111111111111111111111I
I111111111111111111111111111111111111111111111111111111111111111111111111111111111111111111111111111111111I
I111111111111111111111111111111111111111111111111111111111111111111111111111111111111111111111111111111111I
I111111111111111111111111111111111111111111111111111111111111111111111111111111111111111111111111111111111I
I111111111111111111111111111111111111111111111111111111111111111111111111111111111111111111111111111111111I
I111111111111111111111111111111111111111111111111111111111111111111111111111111111111111111111111111111111I
I111111111111111111111111111111111111111111111111111111111111111111111111111111111111111111111111111111111I
I111111111111111111111111111111111111111111111111111111111111111111111111111111111111111111111111111111111I
I111111111111111111111111111111111111111111111111111111111111111111111111111111111111111111111111111111111I
I111111111111111111111111111111111111111111111111111111111111111111111111111111111111111111111111111111111I
I111111111111111111111111111111111111111111111111111111111111111111111111111111111111111111111111111111111I
I111111111111111111111111111111111111111111111111111111111111111111111111111111111111111111111111111111111I
I111111111111111111111111111111111111111111111111111111111111111111111111111111111111111111111111111111111I
I111111111111111111111111111111111111111111111111111111111111111111111111111111111111111111111111111111111I
I111111111111111111111111111111111111111111111111111111111111111111111111111111111111111111111111111111111I
I111111111111111111111111111111111111111111111111111111111111111111111111111111111111111111111111111111111I
I111111111111111111111111111111111111111111111111111111111111111111111111111111111111111111111111111111111I
I111111111111111111111111111111111111111111111111111111111111111111111111111111111111111111111111111111111I
I111111111111111111111111111111111111111111111111111111111111111111111111111111111111111111111111111111111I
I111111111111111111111111111111111111111111111111111111111111111111111111111111111111111111111111111111111I
I111111111111111111111111111111111111111111111111111111111111111111111111111111111111111111111111111111111I
I111111111111111111111111111111111111111111111111111111111111111111111111111111111111111111111111111111111I
I111111111111111111111111111111111111111111111111111111111111111111111111111111111111111111111111111111111I
I111111111111111111111111111111111111111111111111111111111111111111111111111111111111111111111111111111111I
I111111111111111111111111111111111111111111111111111111111111111111111111111111111111111111111111111111111I
I111111111111111111111111111111111111111111111111111111111111111111111111111111111111111111111111111111111I
I111111111111111111111111111111111111111111111111111111111111111111111111111111111111111111111111111111111I
I111111111111111111111111111111111111111111111111111111111111111111111111111111111111111111111111111111111I
I111111111111111111111111111111111111111111111111111111111111111111111111111111111111111111111111111111111I
I111111111111111111111111111111111111111111111111111111111111111111111111111111111111111111111111111111111I
I111111111111111111111111111111111111111111111111111111111111111111111111111111111111111111111111111111111I
I111111111111111111111111111111111111111111111111111111111111111111111111111111111111111111111111111111111I
IIIIIIIIIIIIIIIIIIIIIIIIIIIIIIIIIIIIIIIIIIIIIIIIIIIIIIIIIIIIIIIIIIIIIIIIIIIIIIIIIIIIIIIIIIIIIIIIIIIIIIIIIII
