Grassy,none,1
IIIIIIIIIIIIIIIII
IPPPPPWWWWWPPPPPI
IPPPWWRRRRRWWPPPI
IPPWRRRRRRRWRWPPI
IPWRRRRRRRRWRRWPI
IPWRRRRRRRRWWRWPI
IWRRRRRRRRRWRRRWI
IWRRRRRRRRRRRRRWI
IWRRRWRRRRRRRRRWI
IWRRRWRRRRRRRRRWI
IWWWWWRRWWWWRRRWI
IPWRRRRRRRRWWWWPI
IPWRRRRRRRRRRRWPI
IPPWRRRRRRRRRWPPI
IPPPWWRRRRRWWPPPI
IPPPPPWWWWWPPPPPI
IIIIIIIIIIIIIIIII
