Grassy,none,1
IIIIIIIIIIIIIIIIIIIIII
I11111111WWWW11111111I
I111111WWWWWWWW111111I
I1111WWWCCCCCCWWW1111I
I111WWWWCCCCCCWWWW111I
I11WWWWWCCWWWWWWWWW11I
I11WWWW*RRR*R*R*WWW11I
I1WRRRWRRRRRRRRRR*RW1I
I1WRRRW*RRRRRRRRR*RW1I
IWWRRRWRRRR1RRRRWWWWWI
IWWWRWW*RRRRRRR*WCCCWI
IWWRRRRRRRRRRRRWWCCCWI
IWWRRRRRRRRRRR*WCCCWWI
I1WRRRRRRRCCC*WWCCCW1I
I1WWRRRRCCCCCWWCCCWW1I
I11WRRRCCCCCCCCCCCW11I
I11WWRCCCCCCCCCCCWW11I
I111WWCCCCCCCCCCWW111I
I1111WWWWWCCWWWWW1111I
I111111WWWCCWWW111111I
I11111111WWWW11111111I
IIIIIIIIIIIIIIIIIIIIII
