Grassy,none,1
IIIIIIIIIIII
I1111111111I
I1111111121I
I1112111111I
I1111111111I
I1111112111I
I1112121111I
I1111111111I
I1111111111I
I1211111111I
I1111111111I
IIIIIIIIIIII
