Volcano,none,1,0
IIIIIIIIIIIIIIIIIIIIIIIIIIIIIIIIII
ICCCRCRCRRRWWWWWWWWWWWWRRRRRCCCCCI
ICRRRCRCRCCWRRRRRRRRRRWRCCRRRRCRRI
ICRRRCRCRCRWRRRRRRRRRRWCRRCRRRCRRI
ICRRRCCCRCCWRRRRRRRRRRWCRRCRRRCRRI
ICRRRCRCRCRWRRRRRRRRRRWCCCCRRRCRRI
ICCCRCRCRCCWRRRRRRRRRRWCRRCRRRCRRI
IWWWWWWWWWWWWWWRRRRWWWWWWWWWWWWWWI
IWRRRRRRRRRRRRRRRRRRRRRRRRRRRRRRWI
IWRRRRRRRRRRRRRRRRRRRRRRRRRRRRRRWI
IWRRRRRRRRRRRRRRRRRRRRRRRRRRRRRRWI
IWRRRRRRRRRRRRRRRRRRRRRRRRRRRRRRWI
IWRRRRRRRRRRRRRRRRRRRRRRRRRRRRRRWI
IWRRRRRRRRRRRRRRRRRRRRRRRRRRRRRRWI
IWRRRRRRRRRRRRRRRRRRRRRRRRRRRRRRWI
IWRRRRRRRRRRRRRRRRRRRRRRRRRRRRRRWI
IWRRRRRRRRRRRRRRRRRRRRRRRRRRRRRRWI
IWRRRRRRRRRRRRRRRRRRRRRRRRRRRRRRWI
IWRRRRRRRRRRRRRRRRRRRRRRRRRRRRRRWI
IWRRRRRRRRRRRRRRRRRRRRRRRRRRRRRRWI
IWRRRRRRRRRRRRRRRRRRRRRRRRRRRRRRWI
IWRRRRRRRRRRRRRCCCCRRRRRRRRRRRRRWI
IWRRRRRRRRRRRRRCCCCRRRRRRRRRRRRRWI
IWRRRRRRRRRRRRRCCCCRRRRRRRRRRRRRWI
IWRRRRRRRRRRRRRCCCCRRRRRRRRRRRRRWI
IWRRRRRRRRRRRRRRRRRRRRRRRRRRRRRRWI
IWRRRRRRRRRRRRRRRRRRRRRRRRRRRRRRWI
IWRRRRRRRRRRRRRRRRRRRRRRRRRRRRRRWI
IWRRRRRRRRRRRRRRRRRRRRRRRRRRRRRRWI
IWRRRRRRRRRRRRRRRRRRRRRRRRRRRRRRWI
IWRRRRRRRRRRRRRRRRRRRRRRRRRRRRRRWI
IWRRRRRRRRRRRRRRRRRRRRRRRRRRRRRRWI
IWRRRRRRRRRRRRRRRRRRRRRRRRRRRRRRWI
IWRRRRRRRRRRRRRRRRRRRRRRRRRRRRRRWI
IWRRRRRRRRRRRRRRRRRRRRRRRRRRRRRRWI
IWRRRRRRRRRRRRRRRRRRRRRRRRRRRRRRWI
IWRRRRRRRRRRRRRRRRRRRRRRRRRRRRRRWI
IWRRRRRRRRRRRRRRRRRRRRRRRRRRRRRRWI
IWWWWWWWWWWWWWRRRRRRWWWWWWWWWWWWWI
IWRRRRRRWRRRRRRRRRRRRRRRRWRRRRRRWI
IWRRRRRRWRRRRRRRRRRRRRRRRWRRRRRRWI
IWRRRRRRRRRRRRRRRRRRRRRRRRRRRRRRWI
IWRRRRRRRRRRRRRRRRRRRRRRRRRRRRRRWI
IWRRRRRRWRRRRRRRRRRRRRRRRWRRRRRRWI
IWRRRRRRWRRRRRRRRRRRRRRRRWRRRRRRWI
IWWWWWWWWWWWWWWWWWWWWWWWWWWWWWWWWI
IIIIIIIIIIIIIIIIIIIIIIIIIIIIIIIIII
