Grassy,none,1,0
IIIIIIIIIIIIIIIIIIIIIIIIIII
ILLLLLLLLLLWWWWWLLLLLLLLLLI
ILLLLLLLLLLWCCCWLLLLLLLLLLI
ILLLLLLLLLLWCCCWLLLLLLLLLLI
ILLLLLLLLLLWCCCWLLLLLLLLLLI
IIIIIIIIIIIWCCCWIIIIIIIIIII
I1111111111111111111111111I
I1111111111111111111111111I
I1111111111111111111111111I
I1111111111111111111111111I
I1111111111111111111111111I
I1111111111111111111111111I
I1111111111111111111111111I
I1111111111111111111111111I
I1111111111111111111111111I
I1111111111111111111111111I
I1111111111111111111111111I
I1111111111111111111111111I
I1111111111111111111111111I
I1111111111111111111111111I
I1111111111111111111111111I
I1111111111111111111111111I
I1111111111111111111111111I
I1111111111111111111111111I
I1111111111111111111111111I
I1111111111111111111111111I
I1111111111111111111111111I
I1111111111111111111111111I
I1111111111111111111111111I
I1111111111111111111111111I
I1111111111111111111111111I
IIIIIIIIIIIIIIIIIIIIIIIIIII
