Island,obscure,1,0
LLLLLLLLLLLLLLLLLLLL
LLLLLLL2LLLLLLLLLLLL
LLLL222222222222LLLL
LLL221111111PP*22LLL
LL22111111111R**22LL
LL21111111111RRR22LL
LL2111111111111122LL
LL2111111111111122LL
LL2111111111111122LL
LL22111111WWCCWW2LLL
LLL2211111WCCCCW2LLL
LLLL211111WCCCCW22LL
LLLL211111WCCCCW22LL
LLLL221111WCCCCW22LL
LLL2221111WWWWWW22LL
LL2222222222222222LL
LL2222222222LL222LLL
LLL22LL2222LLL22LLLL
LLLLLLLLLLLLLLLLLLLL
LLLLLLLLLLLLLLLLLLLL
