Grassy,rain,1,0
IIIIIIIIIIIIIIIIIIIIIIIIIIIIIIIIIIIIIIIIIII
IRRR1111WWWWWWWWWWWWW111111111111111111111I
IRRRR111WRRRRRRRRRRRW111111111111111111111I
IRRRRR11WRRRRRRRCCCRW111111111111111111111I
I1RRRRR1WRRRRWRRCCCRW111111111111111111111I
I11RRRR1WWWWWWRRCCCRW11111111111WWWWWWWWWWI
I111RRR1WRRRRRRRRRRRW11111111111WRRRRRRRRWI
I111RRR1WRRRRRRRRRRRW11111111111WRRRWRRRRWI
I111RRR1WRRRRRRRRRRRW11111111111WRRRWRRRRWI
I111RRRRWWRRWWWWWWWWW11111111111WRRRWWWWWWI
I111RRRRRRRRRR111111111111111111WRRRRRRRRWI
I1111RRRRRRRRRR11111111111111111WRCCCCRRRWI
I12211RRRRRRRRRR111WWWWWWWWWW111WRCCCCRRRWI
I11111111111RRRR111WRRRRRRRRW111WRCCCCRRRWI
I112212212211RRR111WRRRWRRRRW111WRRRRRRRRWI
I111111111111RRR111WWWWWRRRRW111WWWRRWWWWWI
I112212212211RRRR11WCCRRRRRRW111RRRRRRRRRRI
I111111111111RRRRR1WCCRRRRRRW1RRRRRRRRRRRRI
I1122111111111RRRRRWWWRRWWWWWRRRRRRRRRRRRRI
I11111RRRRRRRRRRRRRRRRRRRRRRRRRRRR11WW1111I
I11221111WWWWRRWRRRRRRRRRRRRRRR111WWWWRW11I
I11111111RRRRRRW1RRRRRRRRRRRRR11WWWWWRRWWWI
I11221221WRRCCRW11111111111111WWWWWWWRWWWWI
I11111111WRRCCRW111111111111WWWWWWWWWRRRWWI
I11221221WRRRRRW11111111111WWWWWWWWWWWRRWWI
I11111111WWWWWWW1111111111WWWWWWWWWWWWWWWWI
I11221221111111111111111WWWWWWWWWWWWWWWWWWI
I1111111111122111111111WWWWWWWWWWWWWWWWWWWI
I111111111111111111111WWWWWWWWWWWWWWWWWWWWI
I111111111111111111WWWWWWWWWWWWWWWWWWWWWWWI
I1111111111111WWWRWWRRRWWWWWWWWWWWWRRRRRWWI
I111111111111WWRRRRRRRRRWWWRRRRRRRRRRRRRRWI
I11111111111WWRRRRRRRRRRRRRRRRRRRRRRRRRRRWI
I1111111111WWLLLRRRRRRRRRRRRRRRRRRRWWWRRRWI
ILL1111111WLLLLLLRRRRRRRRRRRRRRRRWWWRRRRRWI
ILLLLLLLLLLLLLWWWWWWWWRRRRRRWWWWWWRRRRRRRWI
ILLLLLLLLLLLWWWWWWWWWWWWWWWWWWRRRRRRRRRRRWI
ILLLLLLLLWWWWWWWWWWWWWWWWWWWWRRRRRRRRRRRRWI
ILLLLLLLLWWWWWWWWWWWWWWWWWRRRRRRRRRWRRRRRWI
ILLLLLL11WWWWWWWWWWWWWWRRRRRRRRRRWWWWRRRWWI
ILLLL1111WWWWWWWWWWWWWRRRRRRRRRRWWWWWWWWWWI
I11W11111111WWWWWWWRRRRRRRRRRWWWWWWRRRRWWWI
I111WW111111111RRRRRRRRRRRWWWWWWWWRRRRRRWWI
I1111WWWW1111111RRRRRRRRRRRRRRWWWRRRWRRRRWI
I1111111WWW1111111RRRRRRRRRRRRRRRRRWWRRWWWI
IWW1111111111111111RRRRRRRRRWWWWWWWWWWWWWWI
IWWWWWWWWWW11111111RRRRRRWWWWWWWWWWWWWWWWWI
ILWWWWWWWWWWWW11111RRRRWWWWRRRRRRRRRRRRWWWI
ILLLLLWWWWWWWWWWWWWRWWWWWWRRRRRRRRRRRRRRWWI
ILLLLLLWWWWW1111WWRRRRRRRRRRRRRRRRRRRRRRRWI
ILLLLLLLWW1111111WWRRRRRRRRRRRRRRRRRRRRRRWI
ILLLL1111111111111WWWWWWWRRRRWWWWWWWWRRRRWI
ILLL11111111111111WWWWWWWWWWWWRRRRRRRRRRRWI
IL111111111111111111111WWWWWWRRRRRRRRRRRRWI
I1111111111111111111111111RRRRRRRRRRRRRRWWI
I1111111WWWWWWWW1111111111RRRWWWRRRRRRWWWWI
I11111WRRRR*RWWWW1111111111RRLLWWWWWWWWWWWI
I1111WRRRRRRRWWRWW1111111111LLLLLLLLLWWWWWI
I1111WWRRRRRRRWRRWW1111111LLLLLLLLLLLLLLWWI
I111WWWWWRRRRRWRRRWW1111LLLLLLLLLLL111111WI
I11WW111WW*RRRWRRRRWW11LLLLLLLLLLL1111111WI
I11WW1111WRRRRWWRRRWWW11LLLLLLLLL11111111WI
I11WW1111WRRRRRW****WWW1111LLLLL1111WWW1WWI
I111W1111WWRRR*RRRRRWWWWWWWLLLLLL1WWWWWWWWI
I111W11111WRRRRRRRRRWWW111WWWLLLLWWRRRRRWWI
I111W11111WWRRRRR*RRRW111111WWWWWWWRRRRRRWI
I111W111111WWWRRRRRRRW111111WWRRRRWWWRRRRWI
I111111111111WWRRRRRRRW111111WRRRRRRWWWRRWI
IW11W111111111WWRRRRRRR111111RRRRRRRRRRRRWI
IWWWWWWWWW11111WWWWWWWWWWWWWWWRRRRRRRRRRRWI
IW111111111111111111111W0000WWRRRRRRRRRRRWI
IW111111111111111111111W00000WWRRRRRRRRWWWI
IW111111111111111111111W000000WWWWWWWWWW00I
IW111111111111111111111W000000000000000000I
IW111111111111111111111W000000000000000000I
IW111111111111111111111W000000000000000000I
IW111111111111111111111W000000000000000000I
IW111111111111111111111W000000000000000000I
IW111111111111111111111W000000000000000000I
IW111111111111111111111W000000000000000000I
IW1111111111R1111111111W000000000000000000I
IW111111111111111111111W000000000000000000I
IW111111111111111111111W000000000000000000I
IW111111111111111111111W000000000000000000I
IW111111111111111111111W000000000000000000I
IW111111111111111111111W000000000000000000I
IW111111111111111111111W000000000000000000I
IW111111111111111111111W000000000000000000I
IW111111111111111111111W000000000000000000I
IW111111111111111111111W000000000000000000I
IW111111111111111111111W000000000000000000I
IWWWWWWWWWWWWWWWWWWWWWWW000000000000000000I
IIIIIIIIIIIIIIIIIIIIIIIIIIIIIIIIIIIIIIIIIII
