Volcano,none,1,0
IIIIIIIIIIIIIIIIIIIIIIIIIIIIIIII
IRRRRLLWWWWWWLLLRRRRRRRRRRRWWWWI
IRRRRLLWRRRRLLLLRRRRRRRRRRRRWWWI
IRRRRRLLRRRRLLLLRRRRRRRRRRRRRWWI
IRRRRRLLRRRLLLLRRRRRRRRRRRRRRRWI
IRRRRRRLLRRLLLLRRRRRWWRRRRRRRRRI
IRRRRRRWLRLLLLRRRRRRRWWRRRRRRRRI
IRRRRRRWLRLLLRRRRRRRRWWRRRRRRRRI
IRRRRRRWLLLLRRRRRRRRRRWWRRRRRRRI
IRRRRRRWRLLRRRRRRRRRRRWWRRRRRRRI
IRRRRRRWRLLRRRRRRRRRRRRWWRRRRRRI
IRRRRRRWRLLLRRRRRRRRRRRWWRRRRRRI
IRRRRRRWRRLLLRRLLRRRRRRRWRRRRRRI
IRRRRRRWWRLLLLLLLLLRRRRRWWRRRRRI
IRRRRRRRWRLLLLLLLLLLLRRRWWRRRRRI
IRRRRRRRWLLLLLLLLLLLLLRRWWWRRRRI
I2RRRRRRWLLLLLLLLLLLLLLRRWWRRRRI
I2RRRRRRWWLLLLLLLLLLLLLLRWWRRRRI
I22RRRRRRWLLLLLLLLLLLLLLRWWRRRRI
I222RRRRRWLLLLLLLLLLLLLLRWWRRRRI
I222RRRRRWLLLLLLLLLLLLLLRWWRRRRI
I222RRRRRWLLRRLLLLLLLLLLRRWWRRRI
I222RRRRRWRLLLLLLLLLLLLLRRWWRRRI
I222RRRRRWRRLLLLLLLLLLRRRWWWRRRI
I122RRRRRWWRRRRRPRRRRRRWWWWWRRRI
I122RRRRRWWWWWWWLWWWWWWWWWWRRRRI
I122RRRRRRWWWWWWWWWWWWWWWRRRRRRI
I112RRRRRRRRRRRRLRRRRRRRRRRRRRRI
I112RRRRRRRRRRRRLLRRRRRRRRRRRRRI
I1122RRRRRRRRRRRPPRRRRRRRRRRRRWI
I111222RRRRRRRRRLLLRRRRRRRRRRWWI
IIIIIIIIIIIIIIIIIIIIIIIIIIIIIIII
