Grassy,normal,1
IIIIIIIIIIIIIIIIIIIIIIIIIIIIIIIIIIIIIIIIIIIIIIIIIIIIIII
I0000111111WWWWWWWWWWWWWWWWWWWWWWWWWWWW111111111111111I
I0000111111WRRRRRRRRRRRRRRRRR1RRRW11111W11111111111111I
I1111111111WRRRRWWWRRRRRRRRRRRRRRW111111W1111111111111I
I1111111111WRRRWWWWWRRRRRRRRRRRRRP111111W1111111111111I
I1111111111WRRRWWWWWRRRRRRRRRRRRRW111111W1111111111111I
I1111111111WRRRWWWWWRRRRRRRRRRRRRW111111W1111111111111I
I111111WWWWWRRRRWRWRRRRRWWWWCWWWWWWWW*WWW1111111111111I
I111WWWW111WRRRRRRRRRRRRWCCCCWW111111111W1111111111111I
I11WW111111WRRRRRRRRRRRRWCCCCW1111111111WWWWWWWWWWW111I
I1WW1111111WRRLLLLLRRRRRWCCCCW1111111111WR1R1R1R1RWWW1I
ILLLLLL11LLLLLLLLLLLRRRWWWWWWW1111111111W111111111W11WI
ILLLLLLLLLLLLLRRRLLLLRW11111LLW111111111RR1R1R1R1RR11WI
ILLLLLLLLLLLLRRRRRLLLLLLLL11LLLW11111111W111111111W11WI
IWW1111111WWWWWWWWWLLLLLLLLLLLLLLLLRLLLLWR1R1R1R1RW11WI
IWW11111111111111111LLLLLLLLLLLLLLLRLLLLWWWWWRWWWWWWWWI
I1W11111111111111111W111LLLL11LLLL1111LLLL1111111W1111I
I1W11111111111111111W111111111111111111LLLLL11111W1111I
I1WW1111WWW111111111111111111111111111111LLLL1111W1111I
I11WWWWWWWW1111111111111111111111111111111LLLL111W1111I
I111WW1111WW11111111W11111111111111111111WWLLLLWW11111I
I1111111111WW1111WWWW11111111111111WWWWWWW11LLLLL11111I
I1111111111WW11WWW111WWWWWWWWWWWWWW1111111111LLLLLL111I
I11111111111WWWW1111111111111111111111111111LLLLLLLL11I
IIIIIIIIIIIIIIIIIIIIIIIIIIIIIIIIIIIIIIIIIIIIIIIIIIIIIII
