Grassy,none,1
IIIIIIIIIIIIIIIIIIIIIIIIIIIIIIIIIIIIIIIIIIIIIIIIIIII
I22PPPPPPPPPPPPPPPPPPPPPLLLLLLLLLL11111111111WWWWWWI
I122222222222PPPPPPPPPPPLLLLLLLLLLLLLL111111WWWWWWWI
IRRRRRRR222222PPPPPPPP2222211LLLLLLLLLL1111WWWWWWWWI
IRRRRRRRR122222PPPPPPP22221111LLLLLLLLLL111WWWWWWWWI
IRRRRRRRRRRRRRRPPPPPPRRRRRR11LLLLLLLLLLL111WWWWWWWWI
I111111RRRRRRRRRRRRRRRRRRRRR11LLLLLLLLLLLLLLWWWWWWWI
I1111111RRRRRRRRPPRRRRRRRRRRR11LLLLLLLLLLLLLWWWWWWWI
I11111111112222PPPPP22222RRRRR11LLLLLLLL1111WWWWWWWI
I11111111112222PPPPPP22221RRRR11LLLLLLLL11111WWWWWWI
I11111111122222PPPPPPP22221RRR11LLLLLLL1111111WWW22I
I1111111122222PPPPPPPP22221RRR11LLLLLLL1111112WW222I
I1111111222PPPPPPPPPPPP2222RRR111LLLLL1111112222222I
I11111222PPPPPPPPPPPPPP2222RRR1111LL11111112221WWWWI
I1111222PPPPPPPPPPPPPPPP222RRRR1111111111122211WWWWI
I11222PPPPPPPPPPPPPPPPPP222RRRRRRRRRRRRRRRRRRRRRRRRI
I1122PPPPPPPPPPPPPPPPPPP2222RRRRRRRRRRRRRRRRRRRRRRRI
I1122PPPPPPPPPPPPPPPPPPPP2222RRRRRRRRRRRRRRRRRRRRRRI
I1122PPPPPPPPPPPPPPPPPPPPP222211111111111111111111WI
I1122PPPPPPPPPPPPPPPPPPPPP2222111111111111111111111I
IIIIIIIIIIIIIIIIIIIIIIIIIIIIIIIIIIIIIIIIIIIIIIIIIIII
