Grassy,none,1,0
IIIIIIIIIIIIII
IWWWWWWWWWWWWI
IW*R*R*RRRRRWI
IWRRRRRRRRRRWI
IW*RRRRRCCWWWI
IWRRRRRRCCWWWI
IW*RRRRRCCCCWI
IWRRRRRRCCCCWI
IWRRCCCCCCCCWI
IWRRCCCCCCCCWI
IWRRWWCCCCCCWI
IWRRWWCCCCCCWI
IWWWWWWWWWWWWI
IIIIIIIIIIIIII
